111111111111111111
10C000001100000101
10111P011001010111
110000111C11001001
10110000C111100111
100000111101010111
100000000000000001
10E01000C101101111
100011111111101111
111111111111111111