11111111
1P001C01
10001001
10001011
100000C1
100E0001
10000001
11111111