111111111
101001C01
100000101
101000001
101P00E01
111111111