111111111
1P001C0E1
100010001
100011111
100000C01
111111111