1111111111111111111
1000000000C01000101
10000000000010000E1
1000000000001110001
10000C0C0C0C0010001
10000C0C0C0C0011111
10000C0C0C0C0000001
10000C0C0C0C0000001
10000C0C0P0C0000011
10000C0C0C0C0000001
10000C0C0C0C0000001
1111111111111111111