1111111111111111111
101010101C101010101
11010101010101010E1
1010101010101010101
11111C1C11C1C101011
10000C0C0C0C0011111
10000C0C0C0C0000001
10000C0C0C0C0000001
10000C0C0P0C0000011
10000C0C0C0C0000001
10000C0C0C0C0000001
1111111111111111111