111111111111111111
10C000001110000001
10111P011110111111
110000100000000001
10110000C111011111
100000111101011111
100000000000000001
10E01000C101101111
100011111111101111
111111111111111111