111111111111111111
1E0010C00000000000
100011100000000000
1P0000000000000000
100000000000000000
00C000000000000000
111111111111111111