111111111
100001C11
10P000a01
10C000E01
100000011
111111111