111111111
10001C101
10P001001
10C000001
100000E01
111111111