111111111
100001C01
10P000101
10C000001
100000E01
111111111