111111111
100001C11
10P001001
10C000111
100000E01
111111111