1111111111111111111
1000000000C010001E1
1000000000001000001
1000000000001110001
10000C0C0C0C0010001
10000C0C0C0C0011001
10000C0C0C0C0000001
10000C0C0C0C0000001
10000C0C0P0C0000011
10000C0C0C0C0000001
10000C0C0C0C0000001
1111111111111111111